1.516721469971854e+02
1.874633994745735e+02
1.983700278692825e+02
1.747071185489262e+02
8.617001077136378e+01
1.883034477159655e+01
2.203901240056269e+01
2.563710069934798e+01
2.967427840439486e+01
3.355367560778969e+01
3.532614220497131e+01
3.527340194156758e+01
3.329967154059273e+01
3.033682232890962e+01
2.617989479412568e+01
2.119162683205868e+01
2.256760298567555e+01
2.372243070585118e+01
2.350170426091173e+01
2.208981021313579e+01
2.026420793912871e+01
1.866262172598295e+01
1.855056998800075e+01
1.831861471548502e+01
1.793187486558303e+01
1.704048902111504e+01
1.629455486714616e+01
1.608093534558619e+01
1.569430709135170e+01
1.518892568372539e+01
1.456906691076905e+01
1.382344442803918e+01
1.382457914815591e+01
1.367117814041184e+01
1.345485520526654e+01
1.293356645161353e+01
1.233078940432559e+01
1.208937936215729e+01
1.193868369665641e+01
1.180650825784483e+01
1.154942591995448e+01
1.122286636327686e+01
